1111111111111
1001000000001
1000C11111001
1P00111E000C1
1111111111111